20
7
8
########
#E  P  #
### ## #
#P  C X#
# B CB #
#X    P#
########